............
..##...##...
..##...##...
...~~~~~....
............
..@.....@...
............
...#####....
...#...#....
.2..###....3
.....P......
.....#......
.....E......
