.1.@.....@.2
..****.****.
..*##*.*##*.
..*#*...*#*.
...~~~~~....
............
..@.....@...
...#####....
...#...#....
.3..###.....
.....P......
.....#......
.....E......
