1..........2
............
..##...##...
..##...##...
............
............
...#####....
...#...#....
....###.....
.....P......
.....#......
.....#......
.....E......
